𠓨	vào	入
𢆥	năm	年
𪜀	là	
𡢐	sau	後
𪉥	muối	鹽
𫗒	ăn	食
𡈉	nước	國
㕵	uống	飲
𣎏	có	有
𠊛	người	人
𫜵	làm	爲,做,作
𣈗	ngày	日
𲥟	tháng	月
䀡	xem	
㐌	đã	
𥪞	trong	內
󲋷	vòng	圈
󰘆	mở	開
丿	phút	
𪠞	đi	行
朱	cho	
渃	nước	水
蔞	rau	菜
𤅶	biển	海
𦤾	đến	
𣇞	giờ	時
𫇿	thuốc	藥
𥃞	hết	盡
𲏿	sữa	乳
𨕭	trên	上
眜	mắt	目,眼
鸏	mòng	
媄	mẹ	母
圇	tròn	圓
𫀅	xem	視
